1111111111111111111111111111111111
1000000000000000110000000000000001
1020000000000000110000000000000001
1001110000011100000011100000111001
1001110000011100000011100000111001
1001110000011100000011100000111001
1000000000000000110000000000000001
1000000000000000110000000000000001
1111111111111111110000000000000001
1111111111111111110000000000000001
1000000000000000110000000000000001
1000000030000000110000000000000001
1001110000011100110011100000111001
1001110000011100000011100000111001
1001110000011100110011100000111001
1000000000000000110000000000000001
1000000000000000110000000000000001
1111111111111111111111111111111111