11111111111111111
10000000000000001
10200000000000001
10011100000111001
10011100000111001
10011100000111001
10003000000000001
10000000000000001
11111111111111111