11111111111111111
10000000000000001
10011100000111001
10011100000111301
10000000000000001
10011100000111001
10011100000111001
10020000000000001
11111111111111111